000100000000000000!
000100000000111111!
000120000000120000!
000100020020100000!
002120000111100000!
000120000120000000!
002111111100000000!
000002000000000000!
000000000000000000!